R 1920 1080
NO ./path_to_the_north_texture
SO ./path_to_the_south_texture


WE ./path_to_the_west_texture
EA ./path_to_the_east_texture

S ./path_to_the_sprite_texture
F 255,15,0
C 225,30,0




111111111111 11111111111111
1000000000111 10000000001  
1011000001111110002000001
1001000000000000000000001
111111111011000001110000111111111
100000001111000001110111111111111
111101111 1111011101110010001
111101111 1111011101 10010001
11000000111101011101 10010001
10002000000000001101110010001
100000000E0000001101010010001
1100000111010101111101111010111
11110111 1110101 101111010001
11111111 1111111 111111111111
             1
